A young man stands in his bedroom. It just so happens that today, the 13th of April, 2009, is this young man's birthday. Though it was thirteen years ago he was given life, it is only today he will be given a name!

What will the name of this young man be? 

What is your name?

>take laundry
Hi, take laundry!

Fancy Cat
An Interactive Fiction by Scott and Ash
Release 1 / Serial number 220511 / Inform 7 build 6M62 (I6/v6.33 lib 6/12N) SD

Bedroom
You, take laundry, awaken on the floor and clutch the fibers of the carpet to keep from spinning so much with the room. This is one messy room. This is your room, you remember as you look around. You stand up, unsure as to whether you can avoid falling back down. You see there is a bed you must have missed last night. You should definitely pick up the pile of dirty laundry that sits on the bed.

You can see a bedroom door and a Bed (on which is a Laundry Pile) here.

>inv
You are carrying nothing.

>look
Bedroom
You, take laundry, awaken on the floor and clutch the fibers of the carpet to keep from spinning so much with the room. This is one messy room. This is your room, you remember as you look around. You stand up, unsure as to whether you can avoid falling back down. You see there is a bed you must have missed last night. You should definitely pick up the pile of dirty laundry that sits on the bed.

You can see a bedroom door and a Bed (on which is a Laundry Pile) here.

>get Car Key
You can't see any such thing.

>inv
You are carrying nothing.

>get laundry
You found the car key! It would be a good idea to pick that up.

>get key
You grab the car key.

[Your score has just gone up by one point.]

>get laundry
Taken.

>go through door
(first opening the bedroom door)

kitchen
This is a little less messy. Eat something. You'll need the strength.

You can see a bedroom door, a Front Door and a table (on which is a sandwich) here.

>eat sandwich
(first taking the sandwich)
[Your score has just gone up by one point.]

>go out
(first opening the Front Door)

front yard
The sun is blinding, the grass is green, and the angry mob is holding signs and yelling. It sounds like they are calling for the resignation of some jerk named take laundry!

You can see a Front Door here.

>go in
kitchen
This is a little less messy. Eat something. You'll need the strength.

You can see a Front Door, a bedroom door and a table here.

>close door
Which do you mean, the Front Door or the bedroom door?

>close front door
You close the Front Door.

>go out
(first opening the Front Door)

front yard
The sun is blinding, the grass is green, and the angry mob is holding signs and yelling. It sounds like they are calling for the resignation of some jerk named take laundry!

You can see a Front Door here.

* * *

A young man stands in his bedroom. It just so happens that today, the 13th of April, 2009, is this young man's birthday. Though it was thirteen years ago he was given life, it is only today he will be given a name!

What will the name of this young man be? 

What is your name?

>yo
Hi, yo!

Fancy Cat
An Interactive Fiction by "Scott and Ash" version 0.0.2
Release 1 / Serial number 220513 / Inform 7 build 6M62 (I6/v6.33 lib 6/12N) SD

Bedroom
You, yo, awaken on the floor and clutch the fibers of the carpet to keep from spinning so much with the room. This is one messy room. This is your room, you remember as you look around. You stand up, unsure as to whether you can avoid falling back down. You see there is a bed you must have missed last night. You should definitely pick up the pile of dirty laundry that sits on the bed. The only exit is west.

You can see a bedroom door and a Bed (on which is a Laundry Pile) here.

>go through door
(first opening the bedroom door)

kitchen
This is a little less messy. Eat something. You'll need the strength.

You can see a bedroom door, a Front Door and a table (on which is a sandwich) here.

>x table
On the table is a sandwich.

>x sandwich
This looks like a great sandwich you made last night if you don't say so yourself. Your mouth waters.

* * *

>w
(first opening the bedroom door)

kitchen
You haven't made too much of a mess in here. Eat something. You'll need the strength. Exits are North to go to the living room or out the back door.

You can see a bedroom door, a Back Door and a table (on which is a sandwich) here.

>n
Living room
This is your favorite place to relax and unwind. There is the front door leading outside and a door leading to the kitchen on the south end.

You can see a Front Door here.

>n
You can't go that way.

>out
(first opening the Front Door)

front yard
The sun is blinding, the grass is green, and the angry mob is angry. They appear to be holding signs and yelling. It sounds like they are calling for the resignation of some jerk named yo!

You can see a Front Door here.

>n
You can't go that way.

>e
You can't go that way.

>s
You can't go that way.

>w
You can't go that way.

>in
Living room
This is your favorite place to relax and unwind. There is the front door leading outside and a door leading to the kitchen on the south end.

You can see a Front Door here.

>s
kitchen
You haven't made too much of a mess in here. Eat something. You'll need the strength. Exits are North to go to the living room or out the back door.

You can see a bedroom door, a Back Door and a table (on which is a sandwich) here.

>s
You can't go that way.

>out
(first opening the Back Door)

back yard
You can see a Back Door and a Storm Grate here.

>w
You can't go that way.

>e
You can't go that way.

>n
You can't go that way.

>s
You can't go that way.

>look
back yard
You can see a Back Door and a Storm Grate here.

>x grate
You see nothing special about the Storm Grate.

>lift grate
That's not a verb I recognise.

>open grate
You open the Storm Grate.

>down
Sewer entrance
It is pitch black in here. You are likely to be eaten by a grue!

You can see a Storm Grate here.

>up
back yard
You can see a Storm Grate and a Back Door here.

* * *

A young man stands in his bedroom. It just so happens that today, the 13th of April, 2009, is this young man's birthday. Though it was thirteen years ago he was given life, it is only today he will be given a name!

What will the name of this young man be? 

What is your name?

>l
Hi, l!

Fancy Cat
An Interactive Fiction by "Scott and Ash" version 0.0.2
Release 1 / Serial number 220513 / Inform 7 build 6M62 (I6/v6.33 lib 6/12N) SD

Bedroom
You, l, awaken on the floor and clutch the fibers of the carpet to keep from spinning so much with the room. This is one messy room. This is your room, you remember as you look around. You stand up, unsure as to whether you can avoid falling back down. You see there is a bed you must have missed last night. You should definitely pick up the pile of dirty laundry that sits on the bed. The only exit is west.

You can see a bedroom door and a Bed (on which is a Laundry Pile) here.

* * *

A young man stands in his bedroom. It just so happens that today, the 13th of April, 2009, is this young man's birthday. Though it was thirteen years ago he was given life, it is only today he will be given a name!

What will the name of this young man be? 

What is your name?

>scott
Hi, scott!

Fancy Cat
An Interactive Fiction by "Scott and Ash" version 0.0.2
Release 1 / Serial number 220514 / Inform 7 build 6M62 (I6/v6.33 lib 6/12N) SD

Bedroom
You, scott, awaken on the floor and clutch the fibers of the carpet to keep from spinning so much with the room. This is one messy room. This is your room, you remember as you look around. You stand up, unsure as to whether you can avoid falling back down. You see there is a bed you must have missed last night. You should definitely pick up the pile of dirty laundry that sits on the bed. The only exit is west.

You can see a bedroom door and a Bed (on which is a Laundry Pile) here.

>w
(first opening the bedroom door)

kitchen
You haven't made too much of a mess in here. Eat something. You'll need the strength. Exits are North to go to the living room or south to the back yard.

You can see a bedroom door, a Back Door and a table (on which is a sandwich) here.

>take sandwich
Taken.

>eat sandwich
In this sandwich you have found your Fully Automatic Assult Battle Spork. You are glad that you remembered to hide it so well. Many governments are trying to ban this type of spork since it is fully automatic and has laser sights for greater accuracy. You should consider carrying it at all times.

[Your score has just gone up by one point.]

>look
kitchen
You haven't made too much of a mess in here. Eat something. You'll need the strength. Exits are North to go to the living room or out the back door.

You can see a bedroom door, a Back Door and a table here.

>get spork
You can't see any such thing.

* * *

>w
(first opening the bedroom door)

kitchen
You haven't made too much of a mess in here. Eat something. You'll need the strength. Exits are North to go to the living room or south to the back yard.

You can see a bedroom door, a Back Door and a table (on which is a sandwich) here.

>s
(first opening the Back Door)
It seems to be locked.

>s
(first opening the Back Door)
It seems to be locked.

>unlock back door
What do you want to unlock the Back Door with?

>phone
You can't see any such thing.

>phone
That's not a verb I recognise.

* * *

>get laundry
You found your Cell Phone! It would be a good idea to pick that up.

>get cell phone
You grab the cell phone.  You realize that you don't remember the lock password. Until you remember the passcode you can only use the flashlight or call emergency services with this thing. It still just seems absolutely vital to keep it on you.

  ... In fact there are many things you can't remember right now...

[Your score has just gone up by one point.]

* * *

A young man stands in his bedroom. It just so happens that today, the 13th of April, 2009, is this young man's birthday. Though it was thirteen years ago he was given life, it is only today he will be given a name!

What will the name of this young man be? 

What is your name?

>s
Hi, s!

Fancy Cat
An Interactive Fiction by "Scott and Ash" version 0.0.2
Release 1 / Serial number 220514 / Inform 7 build 6M62 (I6/v6.33 lib 6/12N) SD

Bedroom
You, s, awaken on the floor and clutch the fibers of the carpet to keep from spinning so much with the room. This is one messy room. This is your room, you remember as you look around. You stand up, unsure as to whether you can avoid falling back down. You see there is a bed you must have missed last night. You should definitely pick up the pile of dirty laundry that sits on the bed. The only exit is west.

You can see a bedroom door and a Bed (on which is a Laundry Pile) here.

>w
(first opening the bedroom door)

kitchen
You haven't made too much of a mess in here. Eat something. You'll need the strength. Exits are North to go to the living room or out the back door.

You can see a bedroom door, a Back Door and a table (on which is a sandwich) here.

>eat sandwich
(first taking the sandwich)
In this sandwich you have found your Fully Automatic Assult Battle Spork. You are glad that you remembered to hide it so well. Many governments are trying to ban this type of spork since it is fully automatic and has laser sights for greater accuracy. You should consider carrying it at all times.

[Your score has just gone up by one point.]

>look
kitchen
You haven't made too much of a mess in here. Eat something. You'll need the strength. Exits are North to go to the living room or out the back door.

You can see a bedroom door, a Back Door and a table (on which is a Fully Automatic Battle Spork) here.

>get fully automatic battle spork
Your battle spork is fully operational and loaded.

[Your score has just gone up by one point.]